{
 "keys": [
  "", 
  "9", 
  "8", 
  "4", 
  "5", 
  "7", 
  "16", 
  "6", 
  "2", 
  "12", 
  "10", 
  "13", 
  "14", 
  "11", 
  "3", 
  "15", 
  "1"
 ], 
 "data": {}, 
 "grid": [
  "                                                                                                                                                      ", 
  "                                                                                                                                                      ", 
  "                                                                                                                                                      ", 
  "                                                                                                                                                      ", 
  "                                                                                                                                                      ", 
  "                                                                                                                                                      ", 
  "                                                                                                                                                      ", 
  "                                                                                                                                                      ", 
  "                                                                                                                                                      ", 
  "                                                                                                                                                      ", 
  "                                                                                                                                                      ", 
  "                                  !!!                                                                                                                 ", 
  "                                 !!!!  !                                !!!                               !                                           ", 
  "                               !!!!!!!!                               !!!!! !                            ! !                                          ", 
  "                             !!!!!!!!!!!                            !! !!!!!!                           !!!!!!                                        ", 
  "                            ! !!!!!!!!!!!!                          ! !!!!!!! !                       ! !!!!!                          !              ", 
  "                          !!!!!!!!!! !!!!!                          !!!!!!!!!! !                     !!!!!!!!!!                     ! !!              ", 
  "                         ! !!!!!!   ! !!!!!                        !!!!!  !!!!!!!                   !!!!!!!!!!!!                   !!!!!!             ", 
  "                        !!!!!!!!!!     !!!!!! !                ! !!!!!!    !!!!!!!                !!!!!!!!  !!!!!  !             !!!!!!!!             ", 
  "                      ! !!!!!! !  !!!    !!!!! !               !!!!!!!       !!!!!! !            !!!!!!!! !  !!!!!!!!           ! !!!!!               ", 
  "                      !!!!!!!   !  !! !   !!!!!!!           !!!!!!!!        ! !!!!! !          ! !!!!!!!!     !!!!!!!!         !!!!!!!                ", 
  "                     !!!!!!    !!!   !     !!!!!!!!        ! !!!!!!          !!!!!!!!!        ! !!!!!!!! !!!    !!!!! !      !!!!!!!!                 ", 
  "                     !!!!!     !       !!   !!!!!!!       !!!!!!!          !!! !!!!!!!      !!!!!!!! ! ! ! !!!   !!!!!!!!   !!!!!!!                   ", 
  "                     !!!      !               !!!!!       !!!!!!                !!!!!!!    !!!!!!!! ! !!!   !!    !!!!!! !!!!!!!!!                    ", 
  "                                               !!!!!!! ! !!!!!!         #      ! ! !!!!!!   !!!!!!   ! !           !!!!!!!!!!!!!!   !                 ", 
  "                                #               !!!!!  !!!!!!           ###   !     !!!!!! !!!!!    ! !              !!!!!!!!!!!!  !!!                ", 
  "                             # #                 !!!!!!!!!!!           #####    !     !!!!!!!!!                       !!!!!!!!!! !!!                  ", 
  "                           ###   ##                !!!!!!!! ! !!!      # # # #   ! !   !!!!!!                          !!!!!!!! !!!                   ", 
  "                           ## # ## #                !!!!!!!  !!       ###   #     !!!   !!!!                             !! ! !!!                     ", 
  "                          # #########                !!!!! !!!        #### #        !!    !         #     #                !!!!!            $$$$      ", 
  "                          #  ########                !!! !!!         ########                     ###  #####               !! !             $$$$      ", 
  "                          # ##########                 !!!!         ###########                   ### #######             !!         ##     $$$$      ", 
  "                         ####### #######             !!! !        ###### ########               ###   #########           !         ####   $$$$$      ", 
  "                         ################                        ###### #########             ####  ############      #           ######   $$$$$      ", 
  "                       ####### #   #######                     ########## #######             #    ######## #####    # #   #   # ######    $$$$$      ", 
  "                     ######## #    ########                   ######        ######              #  ######## #######    #####  # ######     $$$$$      ", 
  "                    ########        #########                #####          #######            ##########   ## ##### # #### ###########     $$$$      ", 
  "                    ########           #######             ######           ########          ##########        #######    ##########      $$$$$  $   ", 
  "               %%%  ###                 #######           ######             #########        ####### #          ####### #########         $$$$$  $   ", 
  "               %%%      #               ########        ######                 #  #####      ########              ###############          $$$$ $$   ", 
  "               %%%                       #  ######     ######                    #######    #######                ###########  #          $$$$$$     ", 
  "               %%%                            #####   #####                         ###### ########                 ########## #           $$$$$$     ", 
  "               %%%                             ###########                          ##############                  ######## #             $$$$$  $   ", 
  "               %%%                              #########                           ## #########                      #######              $$$$$$ $   ", 
  "               %%%                               ######                              ## #####                          # # #               $$$$$$ $   ", 
  "               %%%                                 ###                                   ##  #             && &&        ##                 $$$$$$ $   ", 
  "               %%%            &&&                      & && &                  &&& &&&&                &&& &&&&&&                           $$$$$$    ", 
  "               %%%%%      &&& &&& &&                & &&&&&& &               &&&&&&&&&&&&               &&&&&&&&&&&                        $$$$$$     ", 
  "               %%%       & &&&&&&&& &              &&&&&&&&&&&&            &&&&&&&&&&&&&&           & &&&&&&&&&&&&&                        $$$$$ $$   ", 
  "               %%%%    & &&&&&&&&&&&             & &&&&&&&&&&&&&           &&&&&&&&&&&&&&&           &&&&&&&&&&&&&&&                       $$$$$      ", 
  "           %   %%%%     &&&&&&&&&&&&&&           &&&&&&&   &&&&&&          &&&&&&   &&&&&&&         &&&&&&     &&&&& &                     $$$$$      ", 
  "           %%  %%%%    &&&&&&     &&&&          &&&&&&    & &&&&         &&&&&&     &&&&&& &       &&&&&        &&&&&&                     $$$$$      ", 
  "           %%  %%%    &&&&&      &&&&&&&&      &&&&&       &&&&&&&&     &&&&&        &&&&&&&      &&&&&      & &&&&&&&&    &               $$$$$      ", 
  "           %%%%%%%   &&&&&      &  &&&&&&     &&&&&      && & &&&&&    &&&&&        &&&&&&&&&&  &&&&&&       && & &&&&&& &&&&              $$$$$      ", 
  "              %%%%%%  &&&       && &&&&&&&& &&&&&&         &  &&&&&  &&&&&&            &&&&&&&&&&&&&&          & &&&&&&&&&&&&&             $$$$$      ", 
  "            %%%%%%%%  &         &   &&&&&&&&&&&&&          &&  &&&&&&&&&&&            && &&&&&&&&&&             & &&&&&&&&&&                $$$$      ", 
  "               %%%               &  &&&&&&&&&&&            &    &&&&&&&&&            && & &&&&&&&&             &&&   &&&&&&                 $$$$      ", 
  "           % %%%%%%               && & &&&&&&&               &   &&&&&&               &&     &&&                &&&     &                   $$$$      ", 
  "            %%%%%%%               & &     &&                 &                         &&&                       &&&                        $$$$      ", 
  "           %%% %%%%                  &                        & &&                      &&&&&                       &&&            ''''''   $$$$      ", 
  "           %% %%%%                     &&                      &&  &                      &&&&                        &&           ''''''   $$$$      ", 
  "            %  %%%%                    &&&&            ( ( (      &&           ((((((        &           (((   ((                  ''''''  $$$$$      ", 
  "           %%  %%%%         ((((((((                   (((((((                   ((  ((                   (( ((((                  ''''''  $$$$$      ", 
  "           %%  %%%          ((( ((                    (     (                     (   (                   (  (        '''''''''''''''''''  $$$$$      ", 
  "               %%% %         ((( (                    ( ( ((                    (  (((                   (((  ( (     '''''''''''''''''''  $$$$$      ", 
  "               %%%%%        ( (  (                   (( (((((                   ((((((((                 ((((((( (    '''''''''''''''''''   $$$$      ", 
  "               %%%%         (((((((                  (((((((((((              ((((((((( (              ((((((((((((                        $$$$$  $   ", 
  "               %%%%       ((((((((((((             (((((((((((((            ((((((((((((             (((((((((((((((                       $$$$$  $   ", 
  "               %%%%     (((((((((((((((           ((((((((((((((           (((((((((((((((          ((((((((( ((((((                        $$$$ $$   ", 
  "               %%%     ((((((((((((((((         (((((( ( ((((((((         ((((( ( (   ((((         ((((((((((( (((((                       $$$$$$     ", 
  "               %%%    ((((( ( ((( ((((         (((((((((( ( (((((       (((((( ((    ((((((       (((((( (    (( ((((      (               $$$$$$     ", 
  "               %%%   (((((( (    ((((((       ((((( ((      (((((      (((((  (      ((((((     ((((((  (      ( (((((    (((              $$$$$  $   ", 
  "               %%%   ((((  (      ((((((     (((((          ((((((    (((((           (((((((  ((((((           ((((((((((((((             $$$$$$ $   ", 
  "               %%%    ((          (((((((( ((((((           ((((((((((((((            (((((((((((((               (((((((((((              $$$$$$ $   ", 
  "               %%%                  ((((((((((((             ((((((((((((               ((((((((((                (((((((((                $$$$$$ $   ", 
  "               %%%                  ((((((((((   ))           (  ((((((                 ((((((((                   ((((((((                 $$$$$$    ", 
  "               %%%                   (((((((((  ))))      ***   ((((((                    (  (((    +++++++         (  ((((                $$$$$$     ", 
  "               %%%                    (   (((( )))))      ****   ( ((((                       (     +++++++++++++++++++++++++++            $$$$$ $$   ", 
  "               %%%                           ))))))       ****       ,,,,                           +++++++++++++++++++++++++++++          $$$$$      ", 
  "               %%%                          )))))          ***      ,,,,,,  --                        +++++++++++++++++++++++++++++        $$$$$      ", 
  "               %%%                         )))))           ***      ,,,,,   ----------------------                        +++++++++ ++     $$$$$      ", 
  "               %%%                 )   ) ))))))            ***      ,,,,,   ----------------------                             +++++++     $$$$$      ", 
  "               %%%                ) ) ))))))) )            ***     ,,,,     ----------------------                               ++++++    $$$$$      ", 
  "               %%%              ))   ) ))))))))            ****    ,,,,,                                                         ++++++    $$$$$      ", 
  "               %%% %           )))   ))))))))              ****    ,,,, ,           ........ ......... ...                        ++++      $$$       ", 
  "               %%%%            )) )))))))                  **** ,,,,,,,,,           ..........................                     ++++     $$$       ", 
  "               %%%%           ) ) )))))) ))                 ***   ,,,,,       ................................                    ++++++    $$$       ", 
  "               %%%%%          )  ))))))))                   ***,, ,,,,,,    . ................................                    ++++++    $$$       ", 
  "               %%%%           ) ))))))))                    ***,, ,,,, ,    ........................                               +++++    $$$       ", 
  "           %%  %%%%%         ))))))))))                     ***,,,,,,,,,   .....            ........                             +++++++    $$$       ", 
  "           %%  %%%           )))))))))     ////             ***,, ,,,, ,  ......            ... .     ..                       ++ ++++++   $$$$       ", 
  "              %%%%          )))))  )      ///////////       ***, ,,,,,,,    ...           .. .  . ......                       ++ +++++    $$$$       ", 
  "           %   %%%%%      ))))))) )      /////////////////   *,, ,,,,,,,   ....                                                +   +++++   $$$$       ", 
  "           %% %%%%%      )))))))       ////////////////////  *** ,,,,,    . ...                                                 ++++++ +   $$$$       ", 
  "            % %%%%%     ))))))))      //////       ////////  ***  ,,,,     ....  ..                                            + + +++++    $$$       ", 
  "           %%  %%%%   )))))))))      /////              //// *** ,,,, ,   .....  .            00000000000000000000000         ++  ++++     $$$$   $   ", 
  "           %%  %%%   ))))))  )     //////                ////***  ,,,,    ........            00000000000000000000000         +  +++++     $$$$   $   ", 
  "            %  %%%% )))))         //////                 /////    ,,,,,   ......              00000000000000000000000          ++ +++++     $$$  $$   ", 
  "           %% %%%%   )))         /////                    ////    ,,, ,   ......                          ++++++                 ++++++    $$$$$$     ", 
  "           %%  %%%%  ))          ////                      ////  ,,,,,,   ...... .                       ++ +++                  ++++++    $$$$$$     ", 
  "           %%  %%%%              ///                        //// ,,,,     ....   .                        + + +                  ++++++    $$$$$  $   ", 
  "           %   %%%              ////                        /////          ..... .                      ++ +  + ++++++           +++++     $$$$$$ $   ", 
  "               %%% %            ////                         ////         ...... .                ++++++++++++++++++++++++++++++++++++     $$$$$$ $   ", 
  "               %%%%%            ///                       /   ///         .......                 +++++++++++++++++++++++++++++++++        $$$$$$ $   ", 
  "               %%%%             ///                           ////        .....                   +++++++++++++++++++++++++++++++++         $$$ $$    ", 
  "               %%%              ///                        /  ///         ..... ...                    ++++++++    +++++++++++             $$$$$$     ", 
  "               %%%%             ///                        /  ///          ....   .               .    ++++++ + +++  ++++ +++              $$$$  $$   ", 
  "               %%%              ///                         / ///          .....              .....                                        $$$$       ", 
  "               %%%             ////                      ///  ///          ......            . . ....                                      $$$$       ", 
  "               %%%             ////                      /    ///          . .....         .    .......                                    $$$$       ", 
  "               %%%             ///                      /    //////           ......      ..  .... . .                                     $$$$       ", 
  "               %%%             ////                      /   /////             ...............................                             $$$$       ", 
  "               %%%             ////                          /////              ..............................                             $$$$       ", 
  "               %%%              ////                        //// /                ............................                              $$$       ", 
  "               %%%               ////                      / ////                   ... .. . ...  .... ...                                  $$$       ", 
  "                                  ////                    / //////                  ... ....  ..  . .. .. .                                 $$$       ", 
  "                                  ////                    ////////                                                                                    ", 
  "                                   ////                / ////////                                  111    1                                           ", 
  "                                    ////               /////////                                   1 11  11                                           ", 
  "                                    /////           / ////// //                                                                                       ", 
  "                                     ////////       /////// //                                   11  1111 11 1                                        ", 
  "                                      ///////////// ////// /                         11111111111111111111111111111111111111                           ", 
  "                                       ////////////////// /                          11111111111111111111111111111111111111                           ", 
  "                                           ///////////////                           11111111111111111111111111111111111111                           ", 
  "                                                 ////  /                             111111111111111     11 11 1111                                   ", 
  "                                                     //                                     111 11 1 111  11 1 111                                    ", 
  "                                                    /                                                                                                 ", 
  "                                                                                                                                                      ", 
  "                                                                                                                                                      ", 
  "                                                                                                                                                      ", 
  "                                                                                                                                                      ", 
  "                                                                                                                                                      ", 
  "                                                                                                                                                      ", 
  "                                                                                                                                                      ", 
  "                                                                                                                                                      ", 
  "                                                                                                                                                      ", 
  "                                                                                                                                                      ", 
  "                                                                                                                                                      ", 
  "                                                                                                                                                      ", 
  "                                                                                                                                                      ", 
  "                                                                                                                                                      ", 
  "                                                                                                                                                      ", 
  "                                                                                                                                                      ", 
  "                                                                                                                                                      ", 
  "                                                                                                                                                      ", 
  "                                                                                                                                                      ", 
  "                                                                                                                                                      ", 
  "                                                                                                                                                      ", 
  "                                                                                                                                                      ", 
  "                                                                                                                                                      "
 ]
}