{
 "keys": [
  "", 
  "9", 
  "8", 
  "4", 
  "5", 
  "7", 
  "6", 
  "16", 
  "2", 
  "10", 
  "12", 
  "13", 
  "14", 
  "11", 
  "3", 
  "15", 
  "1"
 ], 
 "data": {}, 
 "grid": [
  "                                                                                                    ", 
  "                                                                                                    ", 
  "                                                                                                    ", 
  "                                                                                                    ", 
  "                                                                                                    ", 
  "                                                                                                    ", 
  "                                                                                                    ", 
  "                      ! !!                     !!!                                                  ", 
  "                    !!!!!!!!                    !!!                                                 ", 
  "                   !!!!!!!! !               !! !!!!!!                 !!!                           ", 
  "                !!!!!!!!!!!!               ! !!!!!!!!!!              !!!!!               !!         ", 
  "                ! !!!!!!!!!!!!!            !!!!!!!!!!!!            !!!!!!!!             !!!         ", 
  "                !!!!!!   !!!!!!           !!!!!! !!!!!!!!         !!!!!!!!!!!          !!!!!        ", 
  "               !!!!!!    !!!!!!!!!       !!!!!!   !!!!!!  !     !!!!!!  !!!!!!       !!!!!!         ", 
  "              !!!!!     ! ! !!!!!!!     !!!!!!    !!!!!!!!!    !!!!!!     !!!!!     !!!!!           ", 
  "              !!!!     !!! ! !!!!!!   !!!!!!       !!!!!!!!!  !!!!!    #   !!!!!  !!!!!!            ", 
  "               !          !!  !!!!!! !!!!!!        ! ! !!!!!!!!!!!     ##   !!!!!!!!!!!             ", 
  "                          !!  ! !!!!!!!!!  ##     ! ! ! !!!!!!!!!      ####   !!!!!!!               ", 
  "                      #    !!!   !!!!!!!  ##  ###  ! ! ! !!!!!!        ## #    !!!!!                ", 
  "                    ####    !!!   !!!!! ###   ####   !!    !!!        ## # # #  !!!          $$$    ", 
  "                   #######    !!!   ! ###  ########   !!    !        ####                #   $$$    ", 
  "                 ##########    ! !    ##  ###########  !!!          ########           ###   $$$    ", 
  "               ####### #####     !!     ######## #####  !!!!       ######### #        ##### $$$$    ", 
  "              ######    ######         ######### ######    !!    ###### ##### ##     #####  $$$$    ", 
  "             #####       ######       #######   #########       ###############  # ######   $$$$    ", 
  "         %%%%####          #####      ####### #     ######     ##### ############ ######    $$$$    ", 
  "         %%%% #             #####    ##### ##      ## #####  ######      # ##############    $$$    ", 
  "         %%%%                ##############         # ############        # ###########      $$$   $", 
  "         %%%%                  ############          ## ########           ######### #       $$$  $$", 
  "         %%%%                   #########                &#####              #######        $$$$  $$", 
  "         %%%%      &&& &         #######            & &&  &###          &&    ######        $$$$ $ $", 
  "         %%%%   &&&&&&&&&         ####&&& &       & &&&&&&&&         &&&&&&&     #          $$$$ $ $", 
  "         %%%%   &&&&&&&&&       & &&&&&&&& &     & &&&&&&&&&&      &&&&&&&&&&               $$$$$$ $", 
  "         %%%%  &&&&&&&&&& &   &&&&&&&&&&&&&&    &&&&&&&&&&&&      &&&&&&&&&&&&              $$$$$$  ", 
  "         %%%% &&&&&&&&&&&&&&   &&&&&&  &&&&&&&&&&&&&&&&  &&&&    &&&&&&   &&&&    &          $$$$ $$", 
  "         %%%% &&&&&    &&&&& &&&&&&&    &&&&& &&&&&& &    &&&&  &&&&&      &&&&&&&&&        $$$$$$$ ", 
  "         %%%% &&&       &&&&&&&&&&       &&&&&&&&&&&&     &&&&&&&&&&        &&&&&&&&        $$$$$ $ ", 
  "         %%%%  &       &&&&&&&&&&         &&&&&&&&&& &&&&  &&&&&&&&          &&&&&&          $$$ $$$", 
  "         %%%%           &&&&&&&&           &&&&&&    &  &   &&&&&             &&&&           $$$  $ ", 
  "         %%%%%        &  &&&&&               &    & &   &&           ''                ((((($$$$   $", 
  "         %%%%         &&& & &&&&&&&              &&&     &&&       '''''               ((((( $$$   $", 
  "         %%%%%         &  &   &&                  &       &&     ''''                  ((((($$$$    ", 
  "         %%%%%           &&&&&            '''  '    '             '   '''' '   ((((((((((((( $$$    ", 
  "         %%%%%      ''              '''''  '''' ' '' '''''       '  '''''''''  (((((((((((($$$$$    ", 
  "      %  %%%%%   '''''''          '''''''''      ''''''''''      ' ''''''''''  ((((((((((((( $$$    ", 
  "      %  %%%%%  '''''''''        '''''''''' '   ''''''''''''     ''''''''''''                $$$    ", 
  "       % %%%%% '''''''''''      '''''' ''''  ''''''''' ''''''    '''''''''''''               $$$    ", 
  "      %%%%%%%''''''   '''''   ''''''    '''' ''''''''''  '''''  ''''''  '''''''  ''          $$$    ", 
  "       % %%%%%'''      ''''' '''''       '''''''''''''   '''''''''''' '  '''''''''''         $$$    ", 
  "        %%%%%% '        ''''''''')      ''''''''''''     ' '''''''''''    ''''''''''         $$$    ", 
  "      %%%%%%%            '''''''))      '''''''''''         '''''' ***     '''''''   **      $$$    ", 
  "        %%%%%%            '''' ))))   +++''' '' ''             ' ''*********'**''''*****    $$$$    ", 
  "      % %%%%%%         )   ) ))))))   ++++   ',,'               '  **********************   $$$$    ", 
  "      % %%%%%%        ) )))))))))))    +++   ,,,  ---------------  *********************    $$$$    ", 
  "      % %%%%%%      ))   ) ))))))))    +++   ,,,  ---------------                   ***** * $$$$    ", 
  "      %   %%%%     )))   )))))) )      +++   ,,,  ----.-.--......  . .               ******  $$$    ", 
  "      %%  %%%%     )) ) ))))))         +++   ,,,    ...  .................   **       *****  $$$  $$", 
  "      %   %%%%    ) )) ))))) ))        ++++  ,,,   .......................   **  **  ******* $$$  $$", 
  "          %%%        )))))))           ++++ ,,,,  ........................         **  ***  $$$$  $$", 
  "          %%%%    ) )))))))             +++ ,,,,  .......................          ** ***** $$$$ $ $", 
  "          %%%%   )))))))))) ///////     +++ ,,,   ....   . ... .                   ** ***** $$$$ $ $", 
  "          %%%%   ))))))))) //////////// +++ ,,,   ...     . .     .                **  **** $$$$$$$$", 
  "          %%%%  )))))    ///////////////+++ ,,,   ...   ..  . ... ..               *   **** $$$$$$  ", 
  "          %%%  )))))) ) //////   ///////++++,,,   ...  .. .. . 000000000000000     *   ****  $$$$ $$", 
  "          %%%))))))) ) /////         ///+++,,,,   ...          000000000000000        **** $$$$$$$$ ", 
  "          %%% ))))))  /////           //// ,,,,   ...          000000000000000        *****$$$$$$   ", 
  "          %%% )))))  /////             ////,,,, ......                                *** *  $$$ $$$", 
  "          %%%    )   ////              /////,,  ......            ****               ******  $$$  $ ", 
  "          %%%        ///                ////    .........         ************************  $$$$   $", 
  "          %%%        ///                 ///    ...... ..   .     **********************     $$$   $", 
  "          %%%        ///                 ///    ..... .     .     *********************     $$$$    ", 
  "          %%%        ///                 ///     ..... .                                     $$$    ", 
  "          %%%       ////                 ///     ........... .                             $$$$$    ", 
  "          %%%       ////                 ///      ........................                 $ $$$    ", 
  "          %%%       ////                ////       .......................                   $$$    ", 
  "          %%%        ////               ////       .......................                   $$$    ", 
  "          %%%        ////               ///          ............1..1.1..                    $$$    ", 
  "                      ////             ////          .  ..   .... 11111                      $$$    ", 
  "                       ////          //////                                                         ", 
  "                        ////        //////                    1111 11 111111                        ", 
  "                        ////////// /////                      11111111111111111111                  ", 
  "                         //////////////                 11111111111111111111111111                  ", 
  "                          ////////////                  11111111111111111111111111                  ", 
  "                                ////                    1111111111111111111111                      ", 
  "                                                           111 1  11 111 11   111                   ", 
  "                                                          111                                       ", 
  "                                                                                                    ", 
  "                                                                                                    ", 
  "                                                                                                    ", 
  "                                                                                                    ", 
  "                                                                                                    ", 
  "                                                                                                    ", 
  "                                                                                                    ", 
  "                                                                                                    ", 
  "                                                                                                    ", 
  "                                                                                                    ", 
  "                                                                                                    ", 
  "                                                                                                    ", 
  "                                                                                                    ", 
  "                                                                                                    "
 ]
}