{
 "keys": [
  "", 
  "9", 
  "8", 
  "4", 
  "7", 
  "5", 
  "6", 
  "16", 
  "12", 
  "10", 
  "2", 
  "13", 
  "14", 
  "11", 
  "3", 
  "15", 
  "1"
 ], 
 "data": {}, 
 "grid": [
  "                                                  ", 
  "            !!                                    ", 
  "        !!!!! !!                                  ", 
  "        !!!!! !!        !   !                     ", 
  "         !!!!!!        !!!!!!  !!!!!!             ", 
  "        !!!!!!!!     !!!!!!!!! ! !!!!!!    !!!    ", 
  "       !!!!!!!!!!   !!!!!!!!! !!!!!!!!!!  !!!!    ", 
  "       !!!!# !!!!! !!!!! !!!!!!!!!!!!!!!!!!!!!    ", 
  "        !! # ###!!!!!!! # !!!!!!##!  !!!!!!!!     ", 
  "         #######!!!!!!!###  !!!###### !!!!!!      ", 
  "        ###### # !!! !#!###  !!# ####!  !! ## $$$ ", 
  "      ##########  ! !!!###### # #######! !!###$$$ ", 
  "       #### ##### ##!!#######% #######!#######$$$ ", 
  "    &&&##%   ######!###   ####%%%#%  ######## $$$ ", 
  "    &&&     %%%%##### ## # #%##%%#%%  ####### $$$ ", 
  "    &&&  %%%%%%%######## %%%##%%%%%%%%#### ## $$$ ", 
  "    &&&%%%%%%% %%####%# %%%%%%#%%%%%%### ## # $$$ ", 
  "    &&%%%%%%%%%%%%%%#%%%%%%%%%%%%%%%%%#%#% #  $$$ ", 
  "    &&&%&& %%%%%%%% %%%%%%% %%%%%%%  %%#%%#   $$$ ", 
  "    &&&&%   %'%'%  %%%%%%%  ''%'%%  % %%%%% ((($$$", 
  "    &&&     '%%'' %   %%    ''''     %%%((((((($$ ", 
  "    &&&& '''' ''''''%%%%  '''''   ''%'% %(((((($$ ", 
  "    &&&'''''''''''''%' %'''''''  '''''''((((((($$ ", 
  "    &&''''''''''''''''''''''''''''''''''''    $$$ ", 
  "    &&&''' '''''''' ''''''' '''''''  '''''  $ $$$ ", 
  "    &&&&'   '''''   ))'''' ' ''''**''*******  $$$ ", 
  " &&&&&&      '''++ ))',,,'-'-----**'''*'****$ $$$ ", 
  " &  &&&     ++++++ ))''',''------**'''''''****$$$ ", 
  " &&&&&&    +++++   ))),'''-------....'''' '*$*$$$ ", 
  "  &&&&&  +++++///  )))''''...........      **$$$$ ", 
  "   &&&& +++++//////)),,,,............      **$$$$ ", 
  " & &&&&++++////////)),,,,...    .000000    $**$$$ ", 
  "    &&&+++//////////),,,....... .000000    ***$$$ ", 
  "    &&&+++////     //,,,.... .  0000000*******$$$ ", 
  "    &&&   ///      ///  ....     *************$$$ ", 
  "    &&&   ///       /// ....     ************ $$$ ", 
  "    &&&   ///       /// .............  ***    $$$ ", 
  "    &&&  ////       /// .............         $$$ ", 
  "    &&&   ////     ////..............         $$$ ", 
  "           ///// ////// ...           111         ", 
  "           ///////////  .. .1.11111111111         ", 
  "            ////////     .. 1.11111111111         ", 
  "              /////         1111111111111         ", 
  "                                                  ", 
  "                                                  ", 
  "                                                  ", 
  "                                                  ", 
  "                                                  ", 
  "                                                  ", 
  "                                                  "
 ]
}