{
 "keys": [
  "", 
  "9", 
  "8", 
  "4", 
  "5", 
  "7", 
  "6", 
  "16", 
  "12", 
  "10", 
  "2", 
  "13", 
  "14", 
  "11", 
  "3", 
  "15", 
  "1"
 ], 
 "data": {}, 
 "grid": [
  "                                                  ", 
  "                                                  ", 
  "                                                  ", 
  "           !!           !                         ", 
  "          !!!!!        !!!!       !!!             ", 
  "        !!!!!!!!     !!!!!!!     !!!!!!    !!!    ", 
  "       !!!!!!!!!!   !!!!!!!!!   !!!!!!!!  !!!!    ", 
  "       !!!!  !!!!! !!!!! !!!!!!!!!!!!!!!!!!!!!    ", 
  "        !! #  !!!!!!!!! # !!!!!!!!!  !!!!!!!!     ", 
  "         ####  !!!!!!! ###  !!!!!  ## !!!!!!      ", 
  "        ######   !!! ######  !!! #####  !! ## $$$ ", 
  "      ##########  ! #########   ########  ####$$$ ", 
  "       #### ##### ############ ###############$$$ ", 
  "    %%%##    ##########   #########  &&###### $$$ ", 
  "    %%%%%     ####### &  & #&&&###&& &&####   $$$ ", 
  "    %%%%%&&&&  #####& &&&&&&#&&&& &&&&&#&#    $$$ ", 
  "    %%%&&&&&&&  &##&&&&&&&&&&&#& &&&&&&&      $$$ ", 
  "    %%&%&&&&&&&&&&&''&&&&&&&&&&&&&&&&&&&&&    $$$ ", 
  "    %%%%&& &&&&&&&&'&''''&& &&&&&&&  &&&&&&   $$$ ", 
  "%%  %%%%%   &&&&&   &&'''& ' &&&&& &  &&&&& ((($$ ", 
  " %  %%%      &&& '' ''&& ' ''  & &&     ((((((($$ ", 
  "    %%%%%'''     '''''''  '''' && '&&'' ((((((($$ ", 
  "%   %%%'''''''  ''''''' ''''&&'&&&&&&&&&((((((($$ ", 
  "%% %%%'%''''''''''''''''''''&''&''&''&&&&'    $$$ ", 
  "%% %%%%%'' '''''''' ''''''' '''''''  '''''    $$$ ", 
  " % %%%%%'   ''''' ''))'''''''''''*''********  $$$ ", 
  "%%  %%% %    ''''+')'',''-'-''-'''*'********* $$$ ", 
  " % %%%% %   +++++' )'),'''---'--''**.*********$$$ ", 
  "    %%%%%  +++++   ))),,,--------....     ****$$$ ", 
  "%%% %%%% +++++///  ))),..............      ***$$$ ", 
  " %  %%% %++++//////)),,..............      ***$$$ ", 
  "%   %%%%%++////////)),,.,...  ..0000000    ***$$$ ", 
  "%%  %%%+++//////////),,,........0000000    ***$$$ ", 
  "    %%%%%+////     //,......... 0000000*******$$$ ", 
  "    %%%%  ///      ///.......   .*************$$$ ", 
  "    %%%%% ///       /// ....... ..*********** $$$ ", 
  "    %%% % ///       ///..............  ***    $$$ ", 
  "    %%%  ////       /// .............         $$$ ", 
  "    %%%   ////     //// .............         $$$ ", 
  "           ///// //////  ..... .. ....111         ", 
  "           ///////////     ..1.111..1.111         ", 
  "            ////////        1111111111111         ", 
  "              /////         1111111111111         ", 
  "                                                  ", 
  "                                                  ", 
  "                                                  ", 
  "                                                  ", 
  "                                                  ", 
  "                                                  ", 
  "                                                  "
 ]
}