{
 "keys": [
  "", 
  "49", 
  "161", 
  "38", 
  "21", 
  "95", 
  "64", 
  "17", 
  "218", 
  "196", 
  "61", 
  "33", 
  "160", 
  "8", 
  "209", 
  "62", 
  "243"
 ], 
 "data": {}, 
 "grid": [
  "                                                               !       !!!#$$$$%%%%%%%%%%%%%%%                                  ", 
  "                                                                       !!!##$$$%%%%%%%%%%%%%%%%%%                               ", 
  "                                                                       !!######%%%%%%%%%%%%%%%%%%%%%                            ", 
  "      &                                                               #########%%%%%%%%%%%%%%%%%%%%%%%                          ", 
  "                 &                                                     ######%%%%%%%%%%%%%%%%%%%%%%%%%%                         ", 
  "                                                                       #####%%%%%%%%%%%%%%%%%%%%%%%%%%%%                        ", 
  "                                                                        ####%%%%%%%%%%%%%%%%%%%%%%%%%%%%                        ", 
  "                     &       '                                           #####%%%%%%%%%%%%%%%%%%%%%%%%%                         ", 
  "                    &                                                    ######(((%%%%%%%%%%%%%%%%%%%%                          ", 
  "                                                                          ######(((%%%%%%%%%%%%%%%%%%                           ", 
  "      )                                                                   ######(((((%%%%%%%%%%%%%%%%                           ", 
  "   *                                                                       ####((((((%%%%%%%%%%%%%%%%                           ", 
  "+                                                                           ###((((((((%%%%%%%%%%%%%%                           ", 
  "                                                                              #((((((((%%%%%%%%%%%%%                            ", 
  "    *                                                                         ,,((((---%%%%%%%%%%%%%                            ", 
  "                                                                              ,,((((---%%%%%%%%%%%%%                            ", 
  "                                                                              ,,((((-----%%%%%%%%%%                             ", 
  "                                                                              ,,,...-----%%%%%%%%                               ", 
  "                                                                              ,,......----%%%%%                                 ", 
  "                                                                              ,,.......---%%%%                                  ", 
  "                                                  ,                           ,,.......--.%%%%                                  ", 
  "                                                                              ,.........%%%%%%                                  ", 
  "                                                                             ,,.........%%%%%                                   ", 
  "                                                                             ,,........//%%%%                                   ", 
  "                                                                             ,,........///%%                                    ", 
  "                                                                             ,,........///%                                     ", 
  "                                                                             ,,........///                                      ", 
  "                                                                             ,..........                                        ", 
  "                                                                            ,,..........                                        ", 
  "                                                                            ,,..........                                        ", 
  "                                                                            ,,........                                          ", 
  "                                                                            ,.......                                            ", 
  "                                                                            ,.......                                            ", 
  "                                                                            ,.....                                              ", 
  "                                                                           ,,......                                             ", 
  "                                                                           ,,.....                                              ", 
  "                                                                           ,,,....                                              ", 
  "                                                                           ,,,..                                                ", 
  "                                                                           ,,.....                                              ", 
  "                                                                           ,,.....                                              ", 
  "                                                                          ,,,....                                               ", 
  "                                                                           ,....                                                ", 
  "                                                                           ,,..                                                 ", 
  "                                                                           ,,...     00                                         ", 
  "                                                                            ,,,,                                                ", 
  "                                                                           ,,,,,                                                ", 
  "                                                                             ,,,.                     1                         ", 
  "                                                                              ,,,.                                              ", 
  "                                                                                ,                                               ", 
  "                                                                                                                                ", 
  "                                                                                                                                ", 
  "                                                                                                                                ", 
  "                                                                                                                                ", 
  "                                                                                                                                ", 
  "                                                                                                                                ", 
  "                                                                                                                                ", 
  "                                                                                                                                ", 
  "                                                                                                                                ", 
  "                                                                                                                                ", 
  "                                                                                                                                ", 
  "                                                                                                                                ", 
  "                                                                                                                                ", 
  "                                                                                                                                ", 
  "                                                                                                                                ", 
  "                                                                                                                                ", 
  "                                                                                                                                ", 
  "                                                                                                                                ", 
  "                                                                                                                                ", 
  "                                                                                                                                ", 
  "                                                                                                                                ", 
  "                                                                                                                                ", 
  "                                                                                                                                ", 
  "                                                                                                                                ", 
  "                                                                                                                                ", 
  "                                                                                                                                ", 
  "                                                                                                                                ", 
  "                                                                                                                                ", 
  "                                                                                                                                ", 
  "                                                                                                                                ", 
  "                                                                                                                                ", 
  "                                                                                                                                ", 
  "                                                                                                                                ", 
  "                                                                                                                                ", 
  "                                                                                                                                ", 
  "                                                                                                                                ", 
  "                                                                                                                                ", 
  "                                                                                                                                ", 
  "                                                                                                                                ", 
  "                                                                                                                                ", 
  "                                                                                                                                ", 
  "                                                                                                                                ", 
  "                                                                                                                                ", 
  "                                                                                                                                ", 
  "                                                                                                                                ", 
  "                                                                                                                                ", 
  "                                                                                                                                ", 
  "                                                                                                                                ", 
  "                                                                                                                                ", 
  "                                                                                                                                ", 
  "                                                                                                                                ", 
  "                                                                                                                                ", 
  "                                                                                                                                ", 
  "                                                                                                                                ", 
  "                                                                                                                                ", 
  "                                                                                                                                ", 
  "                                                                                                                                ", 
  "                                                                                                                                ", 
  "                                                                                                                                ", 
  "                                                                                                                                ", 
  "                                                                                                                                ", 
  "                                                                                                                                ", 
  "                                                                                                                                ", 
  "                                                                                                                                ", 
  "                                                                                                                                ", 
  "                                                                                                                                ", 
  "                                                                                                                                ", 
  "                                                                                                                                ", 
  "                                                                                                                                ", 
  "                                                                                                                                ", 
  "                                                                                                                                ", 
  "                                                                                                                                ", 
  "                                                                                                                                ", 
  "                                                                                                                                ", 
  "                                                                                                                                ", 
  "                                                                                                                                ", 
  "                                                                                                                                ", 
  "                                                                                                                                ", 
  "                                                                                                                                "
 ]
}