{
 "keys": [
  "", 
  "245", 
  "238", 
  "154", 
  "60", 
  "189", 
  "142", 
  "53", 
  "101", 
  "45", 
  "103", 
  "102", 
  "72", 
  "163", 
  "98", 
  "205", 
  "153", 
  "30", 
  "207", 
  "206", 
  "110", 
  "65", 
  "129", 
  "58", 
  "136", 
  "105", 
  "191", 
  "57", 
  "81", 
  "171", 
  "86", 
  "170", 
  "182", 
  "80", 
  "236", 
  "16", 
  "210", 
  "89", 
  "140", 
  "22", 
  "68", 
  "186", 
  "4", 
  "112", 
  "200", 
  "202", 
  "93", 
  "94", 
  "74", 
  "5", 
  "3", 
  "84", 
  "194", 
  "96", 
  "31", 
  "2", 
  "199", 
  "190", 
  "88", 
  "162", 
  "44", 
  "83", 
  "107", 
  "100", 
  "139", 
  "91", 
  "175", 
  "50", 
  "97", 
  "155", 
  "32", 
  "18", 
  "168", 
  "226", 
  "118", 
  "14", 
  "244", 
  "126", 
  "214", 
  "113", 
  "36", 
  "188", 
  "193", 
  "99", 
  "131", 
  "172", 
  "220", 
  "54", 
  "208", 
  "152", 
  "56", 
  "25", 
  "73", 
  "19", 
  "35", 
  "185", 
  "197", 
  "40", 
  "26", 
  "63", 
  "230", 
  "69", 
  "119", 
  "121", 
  "223", 
  "229", 
  "28", 
  "204", 
  "92", 
  "27", 
  "52", 
  "67", 
  "95"
 ], 
 "data": {}, 
 "grid": [
  "                                                                                                                                ", 
  "                                                                                                                                ", 
  "                                                                                                                                ", 
  "                                                                                                                                ", 
  "                                                                                                                                ", 
  "                                                                                                                                ", 
  "                                                                                                                                ", 
  "                                                                                                                                ", 
  "                                                                                                                                ", 
  "                                                                                                                                ", 
  "                                                                                                                                ", 
  "                                                                                                                                ", 
  "                                                                                                                                ", 
  "                                                                                                                                ", 
  "                                                                                                                                ", 
  "                                                                                                                                ", 
  "                                                                                                                                ", 
  "                                                                                                                                ", 
  "                                                                                                                                ", 
  "                                                                                                                                ", 
  "                                                                                                                                ", 
  "                                         !  !!                                                                                  ", 
  "                                         !                                                                                      ", 
  "                                        !!!!                                                                                    ", 
  "                                    !  !!! !  !                    !!                                                           ", 
  "                                       !!!   !!         !         !!!!                                                          ", 
  "                                !! !!    !!!                      !!!!                                                          ", 
  "              # ##                !    !!!!                       !!!!                                                          ", 
  "              #####    #  #       !!    !!                        !!!!                                                          ", 
  "           # #######                      !                      !!!!!!                                                         ", 
  "        ###########                                   !          ! !!!!!                                                        ", 
  "        ##########                                                !!!!!!                                                        ", 
  "        ######                                                      !!! !!                                                      ", 
  "        ########    ##                                               !! !!!                                                     ", 
  "        ########                                                       !!!!                                                     ", 
  "         ## ## #                                                       !!!                                                      ", 
  "          #### ##                                                                                                               ", 
  "          #### ###                                                                                                              ", 
  "          ###   #                                                        !!!!                                                   ", 
  "           ##                                                  !!       !!!                                    !                ", 
  "           ##                                   !!                      !!!!!                                                   ", 
  "                                              !!!                      !!!!!!!!!!                                               ", 
  "                                           !!!!!                     !!!!!!!!!!!!                   !                           ", 
  "                                          !!!!                    !!!!!!!!!!!!!!!                 !! !!                         ", 
  "                                         !!!!                   !!!!!!!!!!!!!!!!!                 !!!!!!!                       ", 
  "                                        !!!!                  !!!!!!!!!!!!!!!!!!!                 !!!!! !!!!                    ", 
  "                                        !!!                  !!!!!!!!!!!!!!!!!!!                   !                            ", 
  "                                        !!!                 ! !!!!!!!!!!!!!!!!! !                                               ", 
  "                                       !!!                  ! !!!!!!!!!!!!!!!!!!!                   !                           ", 
  "                                       !!             !  !!!!!!!!!!!!!!!!!!!! !!! !!!   !!          !!                          ", 
  "                                      !!!         !   !  !!!!!!!!!!!!!!!!!!!!!!!!!!!!!  !!!!                                    ", 
  "                                     !!!         !!! !  ! !!!!!!!!!!!!!!!!!!!!!!!!!!!!!!!!!!        !!                          ", 
  "                                      !!         !!!   !! !!!!!!!!!!!!!!!!!!!!!!!!!!!!!!!!!!       !!!!!!!                      ", 
  "                                     !!!         !!! !!!!! !!!!!!!!!!!!!!!!!!!!!!!!!!!!!!!!!       !!!!!!!!                     ", 
  "                                     !!!        !!!!!! !!!! !!!!!!!!!!!!!!!!!!!!!!!!!!!!!!!!  !!!!!!!!!!!!!!                    ", 
  "                 $$ $                 !!!       !!!! !!!!!!!!!!!!!!!!!!!!!!!!!!!!!!!!!!!!!!!! !!!!!!!!!!!!!!! !!!              !", 
  "                $$$$$$                 !        !!!! !!!!!!!!!!!!!!!!!!!!!!!!!!!!!!!!!!!!!!!!!!!!!!!!!!!!!!!!!!!!!              ", 
  "              $ $$$$$                     !     !!!! !!!!!!!!!!!!!!!!!!!!!!!!!!!!!!!!!!!!!!!!!!!!!!!!!!!!!!!!!!!!!       !      ", 
  "             $$$$$$%%!!!                   !!!  !!!! !!!!!!!!!!!!!!!!!!!!!!!!!!!!!!!!!!!!!!!!!!!!!!!!!!!!!!!!!!!!!! !!!!!!!!!!! ", 
  "           $$$$%$$$%%!!!!!         !       !!!!! !!!   !!!!!!!!!!!!!!!!!!!!!!!!!!!!!!!!!!!!!!!!!!!!!!!!!!!!!!!!!!!!!!!!!! !!!!!!", 
  "           $$$$&%%%%!!!!!!!!   !!    !! !!!!!!!!!!!!!!! !!!!!!!!!!!!!!!!!!!!!!!!!!!!!!!!!!!!!!!!!!!!!!!!!!!!!!!!!!!!!!!!!!!!!!!!", 
  "           $$&&&&%%%%!!!!!!!!   !! !!!!!!!!!!!!!!!!! !!!!!!!!!!!!!!!!!!!!!!!!!!!!!!!!!!!!!!!!!!!!!!!!!!!!!!!!!!!!!!!!!!!!!!!!!!!", 
  "           $&&&&&%%%%!!!!!!!!! !! !!!!!!!!!!!!!!!!!! !!!!!!!!!!!!!!!!!!!!!!!!!!!!!!!!!!!!!!!!!!!!!!!!!!!!!!!!!!!!!!!!!!!!!!!!!!!", 
  "          $$&&&&&%%%%!!!!!!!!!  ! !!!!!!!!!!!!!!!!!! !!!!!!!!!!!!!!!!!!!!!!!!!!!!!!!!!!!!!!!!!!!!!!!!!!!!!!!!!!!!!!!!!!!!!!!!!!!", 
  "         $$&&&&&&%%%%!!!  !!! ! !!!!!!!!!!!!!!!!!!! !!!!!!!!!!!!!!!!!!!!!!!!!!!!!!!!!!!!!!!!!!!!!!!!!!!!!!!!!!!!!!!!!!!!!!!!!!!!", 
  "         $$&&&&&&&%%%%!!!    !!!!!!!!!!!!!!!!!!!!!!!!!!!!!!!!!!!!!!!!!!!!!!!!!!!!!!!!!!!!!!!!!!!!!!!!!!!!!!!!!!!!!!!!!!!!!!!!!!!", 
  "         $&&&&&&  %%%!!!!    !!!!!!!!!!!!!!!!!!!!!!!!!!!!!!!!!!!!!!!!!!!!!!!!!!!!!!!!!!!!!!!!!!!!!!!!!!!!!!!!!!!!!!!!!!!!!!!!!!!", 
  "        $$&&&&&&  %%%!!!! !! !!!!!!!!!!!!!!!!!!!!!!!!!!!!!!!!!!!!!!!!!!!!!!!!!!!!!!!!!!!!!!!!!!!!!!!!!!!!!!!!!!!!!!!!!!!!!!!!!!!", 
  "       $$&&&&&&& %%%%%!!!!!!!!!!!!!!!!!!!!!!!!!!!!!!!!!!!!!!!!!!!!!!!!!!!!!!!!!!!!!!!!!!!!!!!!!!!!!!!!!!!!!!!!!!!!!!!!!!!!!!!!! ", 
  "      $$$&&&&&  %%%%%%!!!!!!!!!!!!!!!!!!!!!!!!!!!!!!!!!!!!!!!!!!!!!!!!!!!!!!!!!!!!!!!!!!!!!!!!!!!!!!!!!!!!!!!!!!!!!!!!!!!!!!!!!!", 
  "     $$$$&&&&& %%%%%%%%!!!!!!!!!!!!!!!!!!!!!!!!!!!!!!!!!!!!!!!!!!!!!!!!!!!!!!!!!!!!!!!!!!!!!!!!!!!!!!!!!!!!!!!!!!!!!!!!!!!!!!!!!", 
  "    $$$$$&&&&  %%%%%%%!!!!!!!!!!!!!!!!!!!!!!!!!!!!!!!!!!!!!!!!!!!!!!!!!!!!!!!!!!!!!!!!!!!!!!!!!!!!!!!!!!!!!!!!!!!!!!!!!!!!!!!!  ", 
  "    $$$$$&&&&   %%%%%!!!!!!!!!!!!!!!!!!!!!!!!!!!!!!!!!!!!!!!!!!!!!!!!!!!!!!!!!!!!!!!!!!!!!!!!!!!!!!!!!!!!!!!!!!!  !! !!!!!!!    ", 
  "    $$$$$&&&&  %%%%%!!!!!!!!!!!!!!!!!!!!!!!!!!!!!!!!!!!!!!!!!!!!!!!!!!!!!!!!!!!!!!!!!!!!!!!!!!!!!!!!!!!!!!!!!!!   ! !!!!!!!     ", 
  "    $$$$$&&&&&'%%%%  !!!!!!!!!!!!!!!!!!!!!!!!!!!!!!!!!!!!!!!!!!!!!!!!!!!!!!!!!!!!!!!!!!!!!!!!!!!!!!!!!!!!!!!!!!    !!!!  !      ", 
  "    $$$$$&&&&&    ((!!!!!!!!!!!!!!!!!!!!!!!!!!!!!!!!!!!!!!!!!!!!!!!!!!!!!!!!!!!!!!!!!!!!!!!!!!!!!!!!!!!!!! !!!!   !!!           ", 
  "    $$$ &&&&&    (((!!!!!!!!!!!!!!!!!!!!!!!!!!!!!!!!!!!!!!!!!!!!!!!!!!!!!!!!!!!!!!!!!!!!!!!!!!!!!!!!!            !!!!           ", 
  "        &&&&      )(!!!!!!!!!!!!!!!!!!!!!!!!!!!!!!!!!!!!!!!!!!!!!!!!!!!!!!!!!!!!!!!!!!!!!!!!!!!!!!!!            !!!!            ", 
  "      ** &&&&& )))))!!!!!!!!!!!!!!!!!!!!!!!!!!!!!!!!!!!!!!!!!!!!!!!!!!!!!!!!!!!!!!!!!!!!!!!!!!!!!!!!            !!!!            ", 
  "      ** &&&   )+)))!!!!!!!!!!!!!!!!!!!!!!!!!!!!!!!!!!!!!!!!!!!!!!!!!!!!!!!!!!!!!!!!!!!!!!!!!!!!!!!            !!!!!!           ", 
  "      ***&&    ++++,,,!!!!!!!!!!!!!!!!!!!!!!!!!!!!!!!!!!!!!!!!!!!!!!!!!!!!!!!!!!!!!!!!!!!!!!!!!!!!             !!!!!            ", 
  "      --*    .!!!++,,,!!!!!!!!!!!!!!!!!!!!!!!!!!///!!!!!!!!!!!!!!!!!!!!!!!!!!!!!!!!!!!!!!!!!!!!!!!!            !!!!!  !!        ", 
  "      ----.......++,,,,!!!!!!!!!!!!!!!!!!!!!!//////!!!!!!!!!!!!!!!!!!!!!!!!!!!!!!!!!!!!!!!!!!!!!!!!!           !!!              ", 
  "0   11----.......,,,,,,!!!!!!!!!!!!!!!!!!!!!////////////!!!!!!!!!!!!!!!!!!!!!!!!!!!!!!!2!!!!!!!!!!!!!!         !!!              ", 
  "00 111-----......,,,,,,!!!!!!!!!!!!!!!!!!!!!////////////!!!!!!!!!!!!!!!!!!!!!!!!!!!!!!2222!!!!!!!!!!!!         !!            3  ", 
  "0  11------......4444,444!!!!!!!!!!!//!!!!!!/////////////!!!!!!!!!!!!!55!!!!!!!!!!!!!!2222!!!!!!!!!!!!          !              3", 
  " 6677-----8......44444444!!!!!!!!!!///////!/////////////////!!!!!!!!!!555!!!!!!!!!!!!222222!!!!!!!!! !!        !                ", 
  "66669----8888...444444444444!!!!!!///////////////////////////!!!55555!5555555!!!!55!!222222!!!!!!!!! !!       !                 ", 
  "666666----88::::4444444444444!!!!!////////////////////////////2555555555555555555552222222222!!!!!!! !                          ", 
  "666666;---<<=:==444>>4444444!!!!!!///////////////////////////22255555555555555555552522222222!!2!!!! !                          ", 
  "66666;;;?<<<====@@@@>444444 !!!!!!!////////////////////////2/22225555555555555555555552222222222!!!  !!     !                   ", 
  "66666;????AAB=C@@@@@>4  4  !!!!!!!!   /////////////////////222222555555555555555555222222222222!!!   !                          ", 
  "66666???? BBDBCC@@@@@@  44!!!!!!!!  ////EEE///////////////22222222555555555555555522222222222!!!!!   F   !                      ", 
  "666666 ??? BDDCCC@@@@       !!!!!!  ////EEEE//////////////222222222255555555555522222222222222!!!    FFF                        ", 
  "666     ??  BGCCCHHH         II!!!   ///EEEEEEEE//////////22222222222555555555522222222222222!!!    FFF                         ", 
  "JJJ   6  ???  KCLHHM    MM    III!!    NENNEEEEE//EOOOOOO222222222222222225522222222222222PPP       F                           ", 
  "J     ?  ???? KLQQQM MMMMMMMMMMMRSSS  NNNNNNEEEEEEEEEOO22222222222222222222222222222222222PPP       F                           ", 
  "  JJ  ?    ? ?QQQ QMMMMMMMMMMMMMRSTS  NNNNNNNEEEEUUOO222222222222222222222222222222222 22PP         F                           ", 
  "JJ             QQQQMMMMMMMMMMMMMTTT    NNNNNNNEEEUUUU2222222222222222222222222222222  2  PPV        F                           ", 
  "         ??    QQQQQMMMMMMMMMMMMTTTT   NTTNNNNNNEUWUUU2222222222222222222222222222222 2  PVV V     FF                           ", 
  " XXXXXYY        Q Q QM MMMMZZZ[[[TTTTTTTTTTTNNWWWWW]]]]2222222222222222222222222222222    VVV    FFFF                           ", 
  "XXXXXXYY         QQQ    ^ ZZZZ[[[TTTTTTTTTTTNWWWWWW]]]]]222222222222222222222222222222    VVV FFFFFF                            ", 
  "XXXXXXYY                  ZZZ[[[[TTTTTTTTTTTWWWWWW]]]____22222222222222222222222222222    V  FFFFF F                            ", 
  "XXXXXXYYY`     `         aZZ[[[[[TTTTTTTTTTTWWWWWW]]]____22222222222222222222222222222      FF                                  ", 
  "XXXXXXXY````   ```       bcddd[[[[[TTTTTTTTTWWWW]]]]]]__2222222222222222222222222222222     FF                                  ", 
  "XXXXXXXY``````````eeeeeeeccdddd[[[[TTTTTTTTTWWW]]]]]]_____22222222222222222222222222222      F                                  ", 
  "XXXXXXX```````````eeeeeeeddddddd[ff TTTTTTTT]]]]]]]]_____ggg2222222__222222222222222222                                         ", 
  "XXXXXXX```````````eeeeeeedddddddddd  TTTTTTTT]]]]]]]______gggg2_h2____22222222222222222     F                                   ", 
  "XXXXXXX```````````eeeeeee dddddddddd  TTTTTTT]]]]]___________gg______i2222222222222222     F         F                          ", 
  "XXXXXXX```````````eeeeeee ddddddddddj   kTTT]]]]]]]_________________ii2222222222222222                                          ", 
  "XXXXXXXX``````````eeeeeeee dddddddddd kkl       ]]]_____________m___ii22222222222222n n F                                       ", 
  "XXXXXXXXoo````````eeeeeeee  dddddddddkkklll      _______________m__iiii2222p22222222  n                                         ", 
  "qXXXXXooooorrr````sssssssss ddddddddddddlll       ______________m iiiii22pppp2222                                               ", 
  "qqXXXooooooorrrr``sssssssss  dddddddddddll          __________    iiiiituupp  2                        v                        ", 
  "qqqooooooooorrrrrssssssssss  dddddddddllll          _________      iiittuupp 22       w                                         ", 
  "qqqooooooooorrrrrsssssssssss  dddddxxxlll           ________       iiitttttp          w                                         ", 
  "qqqoooooooorrrrrrssssssssssy   xxdxxxx              _______        iiitttttup        ww                                         ", 
  "zoooooooooorrrrrssssssssssyyy  xxxxxx                ____             ttttttup        w                                         ", 
  "zooo{ooooorrrrrrssssssssss||||yxxxx                  _____        _   ittt}}}p        www              ~                        ", 
  "zzo{{{{{{{{rrrrrssssssssss|||||      xx               ___         _   it t}}pp        wwww                                      ", 
  "z\u007f\u007f{{{{{{{\u0080rrrrrsssssssss||||||\u0081 \u0081\u0081\u0081\u0081                 ___             i   }ppp       wwwww                                      ", 
  "\u0082\u007f\u007f{{{{{{{rrrrr\u0083\u0083ssssssss||||||\u0081\u0081\u0081\u0081\u0081\u0081                 ___\u0084            tt   p        w  www        \u0085                      \u0086      ", 
  "\u0087\u0082{{{{{{{\u0080\u0080rr\u0083\u0083\u0083\u0083sssssss|||||||||\u0081\u0081\u0081                   _ \u0084        _   tt           w   www                                      ", 
  "\u0087\u0082{{{{{{{\u0080\u0080\u0083\u0083\u0083\u0083\u0083\u0083\u0083\u0083ssssss||||||||\u0081\u0081\u0081                \u0088    \u0084\u0084            tt          \u0089w   ww                \u0085                     ", 
  "    {{{\u0080\u0080\u0080\u0080\u0083\u0083\u0083\u0083\u0083\u0083\u0083\u0083\u0083ssssss||||||\u0081\u0081\u0081                 \u0088               \u008a  \u0089\u0089\u0089        \u0089\u0089\u0089    w    \u008b                                 ", 
  "       \u0080\u0080\u0080\u0080\u0083\u0083\u0083\u008c\u008c\u008c\u008c\u008c\u008c\u008c\u008css\u008d\u008e\u008e||\u008e\u0081\u0081\u0081\u0081                  \u0088                \u008a\u008a \u0089\u0089   \u008a   \u0089\u008a\u008a      \u008a                                     ", 
  "       \u0080\u0080\u0080\u0080\u0080\u008f\u008c\u008c\u008c\u008c\u008c\u008c\u008c\u008c\u008c\u008d\u008d\u008d\u008e\u008e\u008e\u008e\u0081\u0081\u0081\u0081                   \u0088               \u008a \u008a\u008a\u0089\u0089\u0089    \u0089\u0089\u0089\u008a\u008a     \u008a                                      ", 
  "       \u0090\u0091\u0091\u0091\u008f\u008f\u008c\u008c\u008c\u008c\u008c\u008c\u008c\u008c\u008c\u008d\u008d\u008d\u008e\u008e\u008e\u008e\u0081\u0081\u0081                                     \u008a \u008a\u008a \u008a   \u008a\u0089\u008a\u008a\u008a\u008a\u008a \u008a\u008a \u008a \u008a                               \u0092    "
 ]
}