{
 "keys": [
  "", 
  "71", 
  "24", 
  "245", 
  "207", 
  "238", 
  "82", 
  "132", 
  "205", 
  "51", 
  "65", 
  "231", 
  "186", 
  "165", 
  "114", 
  "2", 
  "120", 
  "235", 
  "116", 
  "13", 
  "113", 
  "41", 
  "234", 
  "34", 
  "78", 
  "48", 
  "15", 
  "90", 
  "173", 
  "215", 
  "1", 
  "75", 
  "224", 
  "181", 
  "79", 
  "42", 
  "158", 
  "208", 
  "38", 
  "127", 
  "70", 
  "167", 
  "212", 
  "76", 
  "39", 
  "164", 
  "183", 
  "87", 
  "69", 
  "104", 
  "77", 
  "157", 
  "59", 
  "21", 
  "49"
 ], 
 "data": {}, 
 "grid": [
  "                                                                                                                                ", 
  "                                                                                                                                ", 
  "                                                                                                                                ", 
  "                                                                                                                                ", 
  "                                                                                                                                ", 
  "                                                                                                                                ", 
  "                                                                                                                                ", 
  "                                                                                                                                ", 
  "                                                                                                                                ", 
  "                                                                                                                                ", 
  "                                                                                                                                ", 
  "                                                                                                      !!!!!                     ", 
  "                                                                                                    !!!!!!!!!!                  ", 
  "                                                                                                !!!!! !!!!!!  !                 ", 
  "                                                                         ### ####                !!!!!!!!!!!!!!                 ", 
  "                                                                      ### #########           !  !!!!!!!!!!!!!!!                ", 
  "                                                                       ############            !!!! !!!!!!!!!!!!!               ", 
  "                                                                      ##############        !  !!!!!!!!!!!!!!!!!!               ", 
  "                                                                   ## ###############   !!  !! !!!!!!!!!!!!!!!!!                ", 
  "                                                                 # #################   !!! ! !! !!!!!!!!!!!                     ", 
  "                                                                ###################  !!!!!!!!!!! !!!!!!!!! !!! !!   !           ", 
  "                                                               ##################    !!!!!!!!!!!!!!!!!!!!!!!!! !!!  !!!         ", 
  "                                                                ################# #  !!!!!!!!!!!!!!!!!!!!!!!!!!!!! !!!!!        ", 
  "                                                             ##  #################   !!!!!!!!!!!!!!!!!!!!!!!!!!! !!!!!!         ", 
  "                                                             ## ######## ########  !!!!!!!!!!!!!!!!!!!!!!!!!!!!!!!!!!!          ", 
  "                                                            ###  ####### ######## !!!!!!!!!!!!!!!!!!!!!!!!!!!!!!!!!!!!          ", 
  "                                                            ####   ##  ######### !!!!!!!!!!!!!!!!!!!!!!!!!!!!!!!!!!             ", 
  "                                                            ######    ########  !!!!!!!!!!!!!!!!!!!!!!!!!!!!!!!!!!!!!           ", 
  "                                                             ##### ## ########  !!!!!!!!!!!!!!!!!!!!!!!!!!!!!!!!!!!             ", 
  "                                                         #  ##################    !!!!!!!!!!!!!!!!!!!!!!!!!!!!!!!!!!            ", 
  "                                                            ###### ### #####      !!!!!!!!!!!!!!!!!!!!!!!!!!!!!!!!!             ", 
  "                                                            ## ###########        !!!!!!!!!!!!!!!!!!!!!!!!!!!!!!!!              ", 
  "                                                     ##       ##### #######      !!!!!!!!!!!!!!!!!!!!!!!!!!!!!!!!!!!            ", 
  "                                                      ###     #### # ######    !!!!!!!!!!!!!!!!!!!!!!!!!!!!!!!!!!!!!            ", 
  "                                                 ##   ######  #############  !!!!!!!!!!!!!!!!!!!!!!!!!!!!!!!!!!!!!              ", 
  "                                                      #### ## ############# !!!!!!!!!!!!!!!!!!!!!!!!!!!!!!!!!!!!! !             ", 
  "                                                  #      # ##       #######  !!!!!!!!!!!!!!!!!!!!!!!!!!!!!!!!!!!!!              ", 
  "                                                ##      #   ##    # #####     !!!!!!!!!!!!!!!!!!!!!!!!!!!!!!!!!!!!!!            ", 
  "                                            ##  ##   #       # ## ## ####     !  !!!!!!!!!!!!!!!!!!!!!!!!!!!!!!!!!!             ", 
  "                                           ### #      #          #######       !!!!!!!!!!!!!!!!!!!!!!!!!!!!!!!!!!!!!            ", 
  "                                          #### #           ###   ########      !!!!!!!!!!!!!!!!!!!!!!!!!!!!!!!!!!!!!            ", 
  "                                          ### #   #   # ### #############     !!!!!!!!!!!!!!!!!!!!!!!!!!!!!!!!!!!!              ", 
  "                                         ### #### ##  # ###   ##      #        !!!!  !!!!!!!!!!!!!!!!!!!!!!!!!!!!!              ", 
  "                                            # ### ###  ####    ##   ###               !!!!!!!!!!!!!!!!!!!!!!!!!!!!!             ", 
  "                                             ########    ##### #########               !!!!!!!!!!!!!!!!!!!!!!!!!!!!             ", 
  "                                             ######## #  ## ## #########               !!!!!!!!!!!!!!!!!!!!!!!!!!! !            ", 
  "                                               ###           # ########                !!!!!!!!!!!!!!!!!!!!!!!!!!!              ", 
  "                                        ###                                             !!!!!!!!!!!!!!!!!!!!!!!!!!!             ", 
  "                                        ######            # #####                       !!!!!!!!!!!!!!!!!!!!!!!!!!              ", 
  "                                        ######     ###  ### #### ### ####               !!!!!!!!!!!!!!!!!!!!!!!!!!              ", 
  "                                        #######    ###   ####### ## ######              !!!!!!!!!!!!!!!!!!!!!!!!                ", 
  "                                       ######## # #### ########  ###### ##              !!!!!!!!!!!!!!!!!!!!!!!!!               ", 
  "                                       ############ ##  #### #  ### #######              !!!!!!!!!!!!!!!!!!!!!! !               ", 
  "                                       #### ####### ##   ###    ############             !!!!!!!!!!!!!!!!!!!!!!!!               ", 
  "   $                                    ### ##########    # ##  ##############           ! !!!!!!!!!!!!!!!!!!!!!!               ", 
  "                %%%                         ##########      ##   #############             !!!!!!!!!!!!!!!!!!!!!!         &     ", 
  "              %%%%%%%                #       #  #######     ###  ###############          !!!!!!!!!!!!!!!!!!!! !!               ", 
  "             %%%%%%%%%%%% %        # # #     ############   ###   ###### ########        !!!!!!!!!!!!!!!!!!!!!!!!               ", 
  "            %%%%%%%%%%%%%%%%##    ###### ##  ##########   ######    ## ##########         !!!!!!!!!!!!!!!!!!!!!!                ", 
  "           %%%%%%%%%%%%%%%%%### #############  ##### ### ### ###    ### # ######            !!!!!!!!!!!!!!!!!!!                 ", 
  "          %%%%%%%%%%%%%%%%%%###################### ###     #  #### #### #  #####          !!!!!!!!!!!!!!!!!!!!                  ", 
  "          %%%%%%%%%%%%%%%%%%###################   # ###   ############   #########        !!!!!!!!!!!!!!!!!                     ", 
  "            %%%%%%%%%%%%%%%%###################################### ####  ##  ######       !!!!!!!!!!!!!!!                       ", 
  "             %%%%%%%%%%%%%%%###########################################     #########     !!!!!!!!!!!!!!                        ", 
  "           % %%%%%%%%%%%%%%%##########################################      #########     !!!!!!!!!!!!!!            '           ", 
  "         %%%%%%%%%%%%%%%%%%%####################################### #       ##### ##       !!!!!!!!!! !        '' ''''          ", 
  "          %%%%%%%%%%%%%%%%%%###################################### ##    ######## ##       !!!!!!!!!            '''''''         ", 
  "     $    %%%%%%%%%%%%%%%%%%###################################### ###   #########         !!!!!!!!!            ''''''          ", 
  "              %%%%%%%%%%%%%%###################################### ####     #######        !!!!!!!!!            '''''           ", 
  "      %%     %%%%%%%%%%%%%%%####################################   #  # #    ######         !!!!!!!!              ''            ", 
  "           %%%%%%%%%%%%%%%%%###################################      #        ### #         !!!!!!!                             ", 
  "          %%%%%%%%%%%%%%%%%%###################################      # # ####   ##           !!!!!                         (    ", 
  "          %%%%%%%%%%%%%%%%%%##################################           #####               !!!!!                         (    ", 
  "           %%%%%%%%%%%%%%%%%#################################           #######               !!!!                              ", 
  "         %%%%%%%%%%%%%%% %%%%%###############################            ######   #             !!                             )", 
  "             %%%%%% %%       %%%%############################            ######   #                                             ", 
  "             % %%%%           %%%#############################          ######## ###                                         )  ", 
  "                %%%%           %%%#############################          ###########                                       )))  ", 
  "       %        % %%            %%##############################          ###########                                       ))) ", 
  "              %%% %             %%%###############################     ## ###########                                      )))) ", 
  "             %%                  %%%################################     #############                                      ))) ", 
  "           %% %                   %%##################################  ###############                                   *) )))", 
  "          %                       ####################################  ################                                 ***  ))", 
  "        %                         # #####################################################                                *** )))", 
  "    % %                              ################################## #################                                *** )))", 
  "  %                                  ################################## #################                                *   )))", 
  "                                     ################################################# ##                                    )))", 
  "                                      ########################################### ##   ###                                     +", 
  "                                       ##%%%%%%%%%%%%%%%%%%%%%#####################   ####                                   + +", 
  "                                        %%%%%%%%%%%%%%%%%%%%%%%%%%%################   #####                                  +++", 
  "                                        %%%%%%%%%%%%%%%%%%%%%%%%%%%%###########%##   #  , #                                    +", 
  "                                        %%%%%%%%%%%%%%%%%%%%%%%%%%%%%#########%%######                                         +", 
  "                                        %%%%%%%%%%%%%%%%%%%%%%%%%%%%%%#####%%%%%% ##                                           +", 
  "                                        %%%%%%%%%%%%%%%%%%%%%%%%%%%%%%####%%%%%% #   #                                         +", 
  "                                        %%%%%%%%%%%%%%%%%%%%%%%%%%%%%%##%%%%%%                                            ------", 
  "                                        %%%%%%%%%%%%%%%%%%%%%%%%%%%%%%%%%%%%%%%                                           ------", 
  "                                        %%%%%%%%%%%%%%%%%%%%%%%%%%%%%%%%%%%%%                                             .-----", 
  "                                        %%%%%%%%%%%%%%%%%%%%%%%%%%%%%%%%%%%%                                              .-----", 
  "                                        %%%%%%%%%%%%%%%%%%%%%%%%%%%%%%%%%%%                                               .-----", 
  "                                         %%%%%%%%%%%%%%%%%%%%%%%%%%%%%%%%%%                                               .-----", 
  "                                          %%%%%%%%%%%%%%%%%%%%%%%%%%%%%%%%%                                                 -   ", 
  "                                          %%%%%%%%%%%%%%%%%%%%%%%%%%%%%%%%%                                                 ///0", 
  "                                           %%%%%%%%%%%%%%%%%%%%%%%%%%%%%%                                                  ////0", 
  "                                             %%%%%%%%%%%%%%%%%%%%%%%%%%%                                                  //////", 
  "                                             111%%%%%%%%%%%%%%%%%%%%%%%                                                  /////00", 
  "                                              1 11111%%%%%%%%%%%%%%%%%%                                                  ////000", 
  "                                              11111111%1%%%%%  %%    %%                                                  //00000", 
  "                                              11 11111111%%%         %%                                             ---///000000", 
  "                                               11 11111111%           %%                                               222300000", 
  "                                                11111111111           %                                               2233333000", 
  "                                                 1  1111111               4                                          22233335500", 
  "                                                  1  111111          666                                             22233335550", 
  "              %                                     1111111         666666   7                                      222333335555", 
  "                                                     1111111    111     6666                                         33333335555", 
  "                 %                               1    111111   111    8     9:::                                     33333335555", 
  "                                                        111111111;       <   :  = > ?                                33333335555", 
  "                                                          111111@;                  A                                BB333333555", 
  "                                                              1@@CCCC                                          D    BBBB35555555", 
  "                                                                @CCEE                                               BBBB555555FF", 
  "                                                                  EEEE       GH     I                               BBJB55555FFF", 
  "                                                                   EE      GGKKK  K                                   LLLL55FFFF", 
  "                                                                   MMN    GGK KKKKKKK                                  OOLPPPPFQ", 
  "                                                                     NN NNGGGKKKKKKKKK                                 OORPPPPPQ", 
  "                                                                         GGGGKKKKKKKKKS                                 RRRPPPQQ", 
  "                                                                         GGGGGGGKKKKKSSSTTU                              RRPPPPQ", 
  "                                                                         GGGGGGGKKKKVVSTTTUU                                    ", 
  "                                                                        GGGGGGGGKKKVVVSSTTUV                                    ", 
  "                                                                        WGGGGGGVGKKVVVSVVVVVV                                   "
 ]
}