{
 "keys": [
  "", 
  "67", 
  "27", 
  "28", 
  "204", 
  "92", 
  "185", 
  "119", 
  "223", 
  "52", 
  "203", 
  "29", 
  "166", 
  "201", 
  "6", 
  "177", 
  "221", 
  "227", 
  "20", 
  "123", 
  "9", 
  "122", 
  "141", 
  "108", 
  "151", 
  "222", 
  "61", 
  "216", 
  "180", 
  "124", 
  "178", 
  "219", 
  "179", 
  "159", 
  "146"
 ], 
 "data": {}, 
 "grid": [
  "       !!!!##$$$$$$$$%%%%&&&&''                     (                 )))))   )))))) ) )   )))                                  ", 
  "    *  !!!!#$$$$$$$$$%++++&&&&                                          ))))  )))))  ))    ) ))))))                             ", 
  "       !!###$$$$$$$$$,+++++&&                                          ))))))  ))))  )))  ))) )) ))))-     --                   ", 
  "        ##$$$$$$$$$$$+++++++&                                            )))         ) )       ))))))---    -                   ", 
  "         $$$$$$$$$$$$+++++++                                              ))    )      ))         )))-------  -              .  ", 
  "         ///$$/$$$$$$$+++++++           0                                   )))))     )            ))----                       ", 
  "          //////$$$$$11+++++                                                     ))))))))22       ) )-- --      3 3             ", 
  "          //////$$$$$1114++++                                                        )  )            5   ---      33            ", 
  "          ///////11$11114+++6                                                                55  5   5       -                  ", 
  "         ////////111111146666   7  8                                                         55555   55                         ", 
  "         ///////1111111144666     88                                                      5 555555   55                9        ", 
  "         ///////1111116664666    888                                                     555555555   555               9        ", 
  "         ///////1111::::64666   8888                                                   55555555555555555                      ;;", 
  "         <<<<<<<<<::::::666     8888                                                   555555555555555555                     ;;", 
  "         <<<<<<====:::::66      888                                                   55555555555555555555               9      ", 
  "          <<<<<=====::::6      8888                                               5555555555555555555555555          >          ", 
  "          <<<<<======::666     8888                                              555555555555555555555555555          >         ", 
  "           <<<<=====???666     888                                               555555555555555555555555555                    ", 
  "           <<<<====????66      888                                               5555555555555555555555555555                   ", 
  "           <<<<==?????@6                                                         5555555555555555555555555555                   ", 
  "           <<<<???????@?                                                         55555555555555555555555555555                  ", 
  "            <<<?????????                                                          5555555555555555555555555555                  ", 
  "            ???????AA??                                                           5555555555555555555555555555                  ", 
  "             ?????????                                                            555555555555555555555555555                   ", 
  "             ????????                                                             5555555555  555555555555555                   ", 
  "             ???????                                                              5555555       555555555555                    ", 
  "              ??                                                                  555           5 5555555555               B    ", 
  "                                                                                                  5555555555               BB   ", 
  "                                                                                                    5555555                 BB  ", 
  "                                                       C                                            555555                   BB ", 
  "                                                                                                      5 5                   BBB ", 
  "                                                                                                         5                   B  ", 
  "                                                                                                       555                 BBB  ", 
  "                                                                                                        55                BB    ", 
  "                                                                                                        55               BB     ", 
  "                                                                                                                        BBB     ", 
  "                                                                                                                       BBB      ", 
  "                                                                                                                       BBB      ", 
  "                                                                                                                       B        ", 
  "                                                                                                                                ", 
  "                                                 CC                                                                             ", 
  "                                                                                                                                ", 
  "                                                                                                                      B         ", 
  "                                                                                                                                ", 
  "                                                                                                                        B       ", 
  "                                                                                                                                ", 
  "                                                                                                                                ", 
  "                                                                                                                                ", 
  "                                                                                                                                ", 
  "                                                                                                                                ", 
  "                                                                                                                                ", 
  "                                                                                                                                ", 
  "                                                                                                                                ", 
  "                                                                                                                                ", 
  "                                                                                                                                ", 
  "                                                                                                                                ", 
  "                                                                                                                                ", 
  "                                                                                                                                ", 
  "                                                                                                                                ", 
  "                                                                                                                                ", 
  "                                                                                                                                ", 
  "                                                                                                                                ", 
  "                                                                                                                                ", 
  "                                                                                                                                ", 
  "                                                                                                                                ", 
  "                                                                                                                                ", 
  "                                                                                                                                ", 
  "                                                                                                                                ", 
  "                                                                                                                                ", 
  "                                                                                                                                ", 
  "                                                                                                                                ", 
  "                                                                                                                                ", 
  "                                                                                                                                ", 
  "                                                                                                                                ", 
  "                                                                                                                                ", 
  "                                                                                                                                ", 
  "                                                                                                                                ", 
  "                                                                                                                                ", 
  "                                                                                                                                ", 
  "                                                                                                                                ", 
  "                                                                                                                                ", 
  "                                                                                                                                ", 
  "                                                                                                                                ", 
  "                                                                                                                                ", 
  "                                                                                                                                ", 
  "                                                                                                                                ", 
  "                                                                                                                                ", 
  "                                                                                                                                ", 
  "                                                                                                                                ", 
  "                                                                                                                                ", 
  "                                                                                                                                ", 
  "                                                                                                                                ", 
  "                                                                                                                                ", 
  "                                                                                                                                ", 
  "                                                                                                                                ", 
  "                                                                                                                                ", 
  "                                                                                                                                ", 
  "                                                                                                                                ", 
  "                                                                                                                                ", 
  "                                                                                                                                ", 
  "                                                                                                                                ", 
  "                                                                                                                                ", 
  "                                                                                                                                ", 
  "                                                                                                                                ", 
  "                                                                                                                                ", 
  "                                                                                                                                ", 
  "                                                                                                                                ", 
  "                                                                                                                                ", 
  "                                                                                                                                ", 
  "                                                                                                                                ", 
  "                                                                                                                                ", 
  "                                                                                                                                ", 
  "                                                                                                                                ", 
  "                                                                                                                                ", 
  "                                                                                                                                ", 
  "                                                                                                                                ", 
  "                                                                                                                                ", 
  "                                                                                                                                ", 
  "                                                                                                                                ", 
  "                                                                                                                                ", 
  "                                                                                                                                ", 
  "                                                                                                                                ", 
  "                                                                                                                                ", 
  "                                                                                                                                ", 
  "                                                                                                                                ", 
  "                                                                                                                                ", 
  "                                                                                                                                ", 
  "                                                                                                                                "
 ]
}